NO          tx/64/walln.xpm
SO          tx/64/walls.xpm
EA          tx/64/walle.xpm
WE          tx/64/wallw.xpm
F  200,100,0
C 225,30,0

11111111111111111111111111111
0000000000110000000000001001110000111111
1011000011100000000000011111111111111111111111111111
1001001  10011111000000000010000000000000000011111111110
11111101101100000111000000000000111111111111111111111
100000000011000001110111111111111
11110111111111011100000010001
11110111111111011101010010001000000000000000000000111111111
110000000010101011100000010001
1000000N000000001100000010001
10000000000000001101010010001
11000000100101001000111100111000000000000000000000000001
11010101 1110101 101111010001
11011111 1111111 1011111111110000000000000000000000000011110
001               1
1100
1100
100000
111111