NO          tx/64/walln.xpm
SO          tx/64/walls.xpm
WE        tx/64/wallw.xpm
EA          tx/64/walle.xpm


                            
                                    
                        

      
F           220,100,0
C             225,30,0
 
      
           

111111111111111111
1W0000000000000001
100110000000000001
100000000100010001
100100000100010001
100100000100010001
100100000100010001
100000000000000001
100000000000000001
100000000000000001
100000111111110001
100000000000000001
111111111111111111