NO          tx/64/walln.xpm
SO          tx/64/walls.xpm
WE        tx/64/wallw.xpm
EA          tx/64/walle.xpm


      
F          220,100,0
C             225,30,0
 
      
           
1111111111111111111111111111111111111111111
1000000000000S00000000000000000000000000001
1111111111111001100000000000011111111111111
            111111111101111111
            100000000000010001
            101111111111111111
            101
            101
            101
            101
            101
            111