1. ok

1111111111111111111111111111111111111111111
1000000000000S00000000000000000000000000001
1111111111111001100000000000011111111111111
			111111111101111111
			100000000000010001
			101111111111111111
			101
			101
			101
			101
			101
			111

segfault

2. ok

1111111111111111111111111111111111111111111
1000000000000S00000000000000000000000000001
1111111111111001100000000000011111111111111
            111111111101111111
            100000000000010001
            101111111111111111
            101
            101
            101
            101
            101
            111

marque ligne en dehors de la map

3. ok

1111111111111111111111111111111111111111111
1000000000000S00000000000000000000000000001
11111111111110011000000 0000011111111111111
            111111111101111111
            100000000000010001
            101111111111111111
            101
            101
            101
            101
            101
            111

marche avec un espace

4. avec deux perso : met message erreur mais affiche map ok

5. changement nom texture : pas de message d'erreur

5bis.

WE        tx/68/wallw.xpm
WE          tx/64/walw.xpm

-> segfault avec ces choses, mais pas avec ca : NO          tx/68/walln.xpm (retour null)

6. 

NO          
tx/64/walln.xpm
SO          tx/64/walls.xpm
WE        tx/64/wallw.xpm
EA          tx/64/walle.xpm


                            
                                    
                        

      
F           220,100,0
C             225,30,0
 
      
           

1111111111111111111111111111111111111111111
1000000000000S00000000000000000000000000001
11111111111110011000000N0000011111111111111
            111111111101111111
            100000000000010001
            101111111111111111
            101
            101
            101
            101
            101
            111

-> segault en mettant tx/64/walln.xpm en dessous

7.

NO          tx/64/walln.xpm
SO          tx/64/walls.xpm
WE        tx/64/wallw.xpm
EA          tx/64/walle.xpm


									
											
								

      
F           220,100,0
C             225,30,0
 
      
           

1111111111111111111111111111111111111111111
1000000000000S00000000000000000000000000001
11111111111110011000000N0000011111111111111
            111111111101111111
            100000000000010001
            101111111111111111
            101
            101
            101
            101
            101
            111

segault si on met des tabs a la place des espaces au milieu

8.

marche avec les noms :
....cub.
....cup.
....cup
map.cup
mapcub

9.

NO  tx/64/walln.xpm
SO          tx/64/walls.xpm
WE        tx/64/wallw.xpm
EA          tx/64/walle.xpm


                            
                                    
                        

      
F           220,100,0
C             225,30,0
 
      
           

1111111111111111111111111111111111111111111
1000000000000S00000000000000000000000000001
1111111111111001100000000000011111111111111
            111111111101111111
            100000000000010001
            101111111111111111
            101
            101
            101
            101
            101
            111


			<-

-> segfault avec les tab du bas

10. 

F           520,100,0
C             225,30,0

superieur a 255 et ca marche

11.

NO          tx/64/walln.xpm
SO          tx/64/walls.xpm
EA          tx/64/walle.xpm
WE          tx/64/wallw.xpm
F 220,100,0
C 225,30,0
1111111111111111111111111
1000000000110000000000001
1011000001110000000000001
1001000000000000000000001
111111111011000001110000000000001
100000000011000001110111111111111
11110111111111011100000010001
11110111111111011101010010001
11000000110101011100000010001
10000000000000001100000010001
10000000000000001101010010001
11000001110101011111011110N0111
11110111 1110101 101111010001
11111111 1111111 111111111111

-> marche pas si ya pas d espace

12. map

1111111111111111111111111
1000000000110000000000001
1011000001110000000000001
100100000000000000000000100000000000000000
111111111011000001110000000000001
100000000011000001110111111111111
11110111111111011100000010001
11110111111111011101010010001
11000000110101011100000010001
10000000000000001100000010001
10000000000000001101010010001
11000001110101011111011110N0111
11110111 1110101 101111010001
11111111 1111111 111111111111

cette map marche avec 0 non entourne de 1

13.

1111111111111111111111111
1000000000110000000000001
1011000001110000000000001
10010000000000000000000010000N000000000000
111111111011000001110000000000001
100000000011000001110111111111111
11110111111111011100000010001
11110111111111011101010010001
11000000110101011100000010001
10000000000000001100000010001
10000000000000001101010010001
110000011101010111110111100111
11110111 1110101 101111010001
11111111 1111111 111111111111

segfault

14.

