111111111111111111
100000000000000001
100110000000000001
100000000100010001
100100000100010001
100100000100010001
100100000100010001
100000000000000001
1000P0000000000001
100000000000000001
100000111111110001
100000000000000001
111111111111111111