

WE tx/48/wallw.xpm
EA tx/48/walle.xpm
NO tx/48/walln.xpm
SO tx/48/walls.xpm


C 255,255,0
F 255,20,147


11111111111111111111111111111111111111111
100000000000000000000000000000000000000001
1000000000000000000000000000000000000000001
1000000000000000000000000000000000000000001
1111111111111001100000010000011111111111111
            111111111101111111
            100000000000010001
            100000000000000101
            1111111111111111S1
                            10