WE tx/48/wallw.xpm
EA tx/48/walle.xpm
NO tx/48/walln.xpm
SO tx/48/walls.xpm


C 255,255,0
F 255,20,147


      111111111111111111
      100000000000000001
      111011111111111101
      110000000000000101
      110000000100000101
      100000000100000101
      100000000100000101
      100000000100011101
      100000000100010001
      100000000100010101
      100000000100010101
      10111111111011101
      100111111110111011
      1E000000000000001
      111111111111111111