WE tx/64/wallw.xpm
EA tx/64/walle.xpm
NO tx/64/walln.xpm
SO tx/64/walls.xpm
F 122,200,122
C 122,122,122





         111111
         100101
         101001
         1100N1
         111111
